C 200,30,50
F 220,100,12

1111111111
1000000001
1000001001
1000000001
10000W11D1
1000000001
1111111111
