C 120,120,200
F 20,90,20

11111111111111111
10000000000000001
10111111111111101
101           101
101    111    101
101    101    101
101    111    101
101           101
10111111111111101
1000000000N000001
11111111111111111