C 200,30,50
F 220,100,12

1111111111
1000000001
1000001D11
1000N0D001
1000001D11
100000D001
1111111111
