C 208,224,227
F 78,55,30

        1111111111111111111111111
        10DD0DDDDD01111D111111111
        1D11D11111D1111D111111111
        1D11000011D1111D111111111
111111111D11111D11D1111D111111111
100000000011000001D10110111111111
1111011D111111011100000010001
1111011D111111011101010000001
1100000011010101110000001D1D1
10000000000000000000000010001
10000000000000001101D10000101
11000001110101011111011100E11
11110111 1110101 101111000001
11111111 1111111 111111111111
