NO ./maps/textures/wall_plants_shadow.xpm
SO ./maps/textures/wall_plants_shadow_thunder_6_blue.xpm
WE ./maps/textures/wall_plants_light_thunder_6_red.xpm
EA ./maps/textures/wall_plants_green.xpm

C 208,224,227
F 78,55,30

        1111111111111111111111111
        1000000000110000000000001
        1011000001110000000000001
        1001000000000000000000001
111111111011000001110000000000001
100000000011000001110110111111111
11110111111111011100000010001
11110111111111011101010000001
11000000110101011100000010001
10000000000000000000000010001
10000000000000001101010000101
11000001110101011111011100N0111
11110111 1110101 101111000001
11111111 1111111 111111111111
