NO ./path_to_the_north_texture.xpm
SO ./path_to_the_south_texture.xpm
WE ./path_to_the_west_texture.xpm
EA ./path_to_the_east_texture.xpm

C 225,30,0
F 255,12,0

11111111111111111
1000000000N000001
10111111111111101
101           101
101    111    101
101    101    101
101    111    101
101           101
10111111111111101
10000000000000001
11111111111111111