NO ./path_to_the_north_texture.xpm
SO ./path_to_the_south_texture.xpm
WE ./path_to_the_west_texture.xpm
EA ./path_to_the_east_texture.xpm

C 225,30,0
F 220,100,12

111111111
100000001
100000101
1000E0001
101000101
100000001
111111111
